NO ./src/textures/north.xpm
         SO            ./src/textures/south.xpm



E                     ./src/textures/east.xpm
WE                                                       ./src/textures/west.xpm


F                  204,192,0




C 225,30,1


111111
100001
100001
111111