NO ./src/textures/north.xpm
       SO            ./src/textures/south.xpm
EA                         ./src/textures/east.xpm
W   ./src/textures/west.xpm
        F                             204,                                                                     192                                  ,0
C 225,                                                     30,1
























        111111111111111111111111
        1000000000110000000000001
        1011000001110000000000001
        1001000000000000000000001
111111111011000001110000000000001
100000000011000001110111110111111
11110111111111011100N00010001    
11110111111111011101010010001    
11000000110101011100000010001
10000000000000001100000010001
10000000000000001101010010001
11000001010101011111011110111
1111011101110101 101111010001
1111111111111111 111111111111